....................................................................................................................................................................................................................
B....................................................................................................................................................................................................................
B....................................................................................................................................................................................................................
B...................................................................................Y..Y.............................................................................................................................
B............Y...Y...................................................................................................................................................................................................
B....................................................................................................................................................................................................................
B....YY..............................................................................................................................................................................................................
B....................................................................................................................................................................................................................
B....................................................................................................................................................................................................................
B................................................B..................................................................................................................................................................
B.............................B......................................................................................................................................................................................
B.............................B......................................................................................................................................................................................
B.............................B......................................................................................................................................................................................
AAAAAAAAAAAAAAAAAAAAAAAAAAAAAAAAAAAAAAAAAAAAAAAAAAAAAAAAAAAAAAAAAAAAA..AAAAAAAAAAAAAAA...AAAAAAAAAAAAAAAAAAAAAAAAAAAAAAAAAAAAAAAAAAAAAAAAAAAAAAAAAAAAAAAA..AAAAAAAAAAAAAAAAAAAAAAAAAAAAAAAAAAAAAAAAAAAAAAAAAAAAAAAAAA