RRRRRRRRRRRRRRRRRRRR
J..................J
J..................J
J..................J
J..................J
J..................J
J..................J
J..................J
J..................J
J..................J
J..................J
J..................J
J..................J
AAAAAAAAAAAAAAAAAAAA