RRRRRRRRRRRRRRRRRRRR.................................................................................................................................................................................................
J..................J.................................................................................................................................................................................................
J..................J.................................................................................................................................................................................................
J..................J.................................................................................................................................................................................................
J..................J.................................................................................................................................................................................................
J..................J.................................................................................................................................................................................................
J..................J.................................................................................................................................................................................................
J..................J.................................................................................................................................................................................................
J..................J.................................................................................................................................................................................................
J........NM........J.................................................................................................................................................................................................
J........NM........J.................................................................................................................................................................................................
J........NM........J.................................................................................................................................................................................................
J........NM........J.................................................................................................................................................................................................
AAAAAAAAAAAAAAAAAAAAAAAAAAAAAAAAAAAAAAAAAAAAAAAAAAAAAAAAAAAAAAAAAAAAA..AAAAAAAAAAAAAAA...AAAAAAAAAAAAAAAAAAAAAAAAAAAAAAAAAAAAAAAAAAAAAAAAAAAAAAAAAAAAAAAA..AAAAAAAAAAAAAAAAAAAAAAAAAAAAAAAAAAAAAAAAAAAAAAAAAAAAAAAAAA