BBBBBBBBBBBBBBBBBBBB.................................................................................................................................................................................................
B..................B.................................................................................................................................................................................................
B..................B.................................................................................................................................................................................................
B..................B................................................................Y..Y.............................................................................................................................
B..................B.................................................................................................................................................................................................
B..................B.................................................................................................................................................................................................
B..................B.................................................................................................................................................................................................
B..................B.................................................................................................................................................................................................
B..................B.................................................................................................................................................................................................
B........DD........B..............................B..................................................................................................................................................................
B........DD........B..........B......................................................................................................................................................................................
B........DD........B..........B......................................................................................................................................................................................
B........DD........B..........B......................................................................................................................................................................................
AAAAAAAAAAAAAAAAAAAAAAAAAAAAAAAAAAAAAAAAAAAAAAAAAAAAAAAAAAAAAAAAAAAAA..AAAAAAAAAAAAAAA...AAAAAAAAAAAAAAAAAAAAAAAAAAAAAAAAAAAAAAAAAAAAAAAAAAAAAAAAAAAAAAAA..AAAAAAAAAAAAAAAAAAAAAAAAAAAAAAAAAAAAAAAAAAAAAAAAAAAAAAAAAA